WWWWWWWWWWWWWWW
W             W
W W W W W W W W
W             W
W W W W W W W W
W             W
W WWWWWWWWWWW W
W B         B W
W WWWWWBWWWWW W
W     W W     W
W W W W W W W W
W     W W     W
W W W WBW W W W
W             W
WWWWWWWWWWWWWWW